"filename", "language", "XML", "Markdown", "PowerShell", "JSON", "comment", "blank", "total"
"c:\Users\USERAS\Desktop\Projects\CSharp\PortfolioProject\TechtonicFramework\packages\CloudinaryDotNet.1.27.6\README.md", "Markdown", 0, -85, 0, 0, 0, -34, -119
"c:\Users\USERAS\Desktop\Projects\CSharp\PortfolioProject\TechtonicFramework\packages\CloudinaryDotNet.1.27.6\lib\net452\CloudinaryDotNet.xml", "XML", -19457, 0, 0, 0, 0, -35, -19492
"c:\Users\USERAS\Desktop\Projects\CSharp\PortfolioProject\TechtonicFramework\packages\CloudinaryDotNet.1.27.6\lib\netstandard1.3\CloudinaryDotNet.xml", "XML", -19457, 0, 0, 0, 0, -35, -19492
"c:\Users\USERAS\Desktop\Projects\CSharp\PortfolioProject\TechtonicFramework\packages\CloudinaryDotNet.1.27.6\lib\netstandard2.0\CloudinaryDotNet.xml", "XML", -19462, 0, 0, 0, 0, -35, -19497
"c:\Users\USERAS\Desktop\Projects\CSharp\PortfolioProject\TechtonicFramework\packages\EntityFramework.6.5.1\README.md", "Markdown", 0, -19, 0, 0, 0, -16, -35
"c:\Users\USERAS\Desktop\Projects\CSharp\PortfolioProject\TechtonicFramework\packages\EntityFramework.6.5.1\buildTransitive\EntityFramework.props", "XML", -3, 0, 0, 0, 0, -1, -4
"c:\Users\USERAS\Desktop\Projects\CSharp\PortfolioProject\TechtonicFramework\packages\EntityFramework.6.5.1\buildTransitive\EntityFramework.targets", "XML", -3, 0, 0, 0, 0, -1, -4
"c:\Users\USERAS\Desktop\Projects\CSharp\PortfolioProject\TechtonicFramework\packages\EntityFramework.6.5.1\buildTransitive\net6.0\EntityFramework.props", "XML", -3, 0, 0, 0, 0, -1, -4
"c:\Users\USERAS\Desktop\Projects\CSharp\PortfolioProject\TechtonicFramework\packages\EntityFramework.6.5.1\buildTransitive\net6.0\EntityFramework.targets", "XML", -3, 0, 0, 0, 0, -1, -4
"c:\Users\USERAS\Desktop\Projects\CSharp\PortfolioProject\TechtonicFramework\packages\EntityFramework.6.5.1\build\EntityFramework.DefaultItems.props", "XML", -6, 0, 0, 0, 0, -1, -7
"c:\Users\USERAS\Desktop\Projects\CSharp\PortfolioProject\TechtonicFramework\packages\EntityFramework.6.5.1\build\EntityFramework.props", "XML", -3, 0, 0, 0, 0, -1, -4
"c:\Users\USERAS\Desktop\Projects\CSharp\PortfolioProject\TechtonicFramework\packages\EntityFramework.6.5.1\build\EntityFramework.targets", "XML", -91, 0, 0, 0, -28, -34, -153
"c:\Users\USERAS\Desktop\Projects\CSharp\PortfolioProject\TechtonicFramework\packages\EntityFramework.6.5.1\build\net6.0\EntityFramework.props", "XML", -6, 0, 0, 0, 0, -1, -7
"c:\Users\USERAS\Desktop\Projects\CSharp\PortfolioProject\TechtonicFramework\packages\EntityFramework.6.5.1\build\net6.0\EntityFramework.targets", "XML", -3, 0, 0, 0, 0, -1, -4
"c:\Users\USERAS\Desktop\Projects\CSharp\PortfolioProject\TechtonicFramework\packages\EntityFramework.6.5.1\lib\net40\EntityFramework.SqlServer.xml", "XML", -2022, 0, 0, 0, 0, -1, -2023
"c:\Users\USERAS\Desktop\Projects\CSharp\PortfolioProject\TechtonicFramework\packages\EntityFramework.6.5.1\lib\net40\EntityFramework.xml", "XML", -46605, 0, 0, 0, 0, -194, -46799
"c:\Users\USERAS\Desktop\Projects\CSharp\PortfolioProject\TechtonicFramework\packages\EntityFramework.6.5.1\lib\net45\EntityFramework.SqlServer.xml", "XML", -2156, 0, 0, 0, 0, -1, -2157
"c:\Users\USERAS\Desktop\Projects\CSharp\PortfolioProject\TechtonicFramework\packages\EntityFramework.6.5.1\lib\net45\EntityFramework.xml", "XML", -53929, 0, 0, 0, 0, -212, -54141
"c:\Users\USERAS\Desktop\Projects\CSharp\PortfolioProject\TechtonicFramework\packages\EntityFramework.6.5.1\lib\netstandard2.1\EntityFramework.SqlServer.xml", "XML", -2156, 0, 0, 0, 0, -1, -2157
"c:\Users\USERAS\Desktop\Projects\CSharp\PortfolioProject\TechtonicFramework\packages\EntityFramework.6.5.1\lib\netstandard2.1\EntityFramework.xml", "XML", -53766, 0, 0, 0, 0, -212, -53978
"c:\Users\USERAS\Desktop\Projects\CSharp\PortfolioProject\TechtonicFramework\packages\EntityFramework.6.5.1\tools\EntityFramework6.PS2.psd1", "PowerShell", 0, 0, -35, 0, -246, -30, -311
"c:\Users\USERAS\Desktop\Projects\CSharp\PortfolioProject\TechtonicFramework\packages\EntityFramework.6.5.1\tools\EntityFramework6.PS2.psm1", "PowerShell", 0, 0, -168, 0, -553, -36, -757
"c:\Users\USERAS\Desktop\Projects\CSharp\PortfolioProject\TechtonicFramework\packages\EntityFramework.6.5.1\tools\EntityFramework6.psd1", "PowerShell", 0, 0, -28, 0, -274, -42, -344
"c:\Users\USERAS\Desktop\Projects\CSharp\PortfolioProject\TechtonicFramework\packages\EntityFramework.6.5.1\tools\EntityFramework6.psm1", "PowerShell", 0, 0, -719, 0, -559, -154, -1432
"c:\Users\USERAS\Desktop\Projects\CSharp\PortfolioProject\TechtonicFramework\packages\EntityFramework.6.5.1\tools\init.ps1", "PowerShell", 0, 0, -28, 0, -218, -7, -253
"c:\Users\USERAS\Desktop\Projects\CSharp\PortfolioProject\TechtonicFramework\packages\EntityFramework.6.5.1\tools\install.ps1", "PowerShell", 0, 0, -26, 0, -215, -6, -247
"c:\Users\USERAS\Desktop\Projects\CSharp\PortfolioProject\TechtonicFramework\packages\EntityFramework.6.5.1\tools\net6.0\any\ef6.runtimeconfig.json", "JSON", 0, 0, 0, -12, 0, 0, -12
"c:\Users\USERAS\Desktop\Projects\CSharp\PortfolioProject\TechtonicFramework\packages\Microsoft.AspNet.Identity.Core.2.2.4\lib\net45\Microsoft.AspNet.Identity.Core.xml", "XML", -2740, 0, 0, 0, 0, -1, -2741
"c:\Users\USERAS\Desktop\Projects\CSharp\PortfolioProject\TechtonicFramework\packages\Microsoft.AspNet.Identity.EntityFramework.2.2.4\lib\net45\Microsoft.AspNet.Identity.EntityFramework.xml", "XML", -1064, 0, 0, 0, 0, -1, -1065
"c:\Users\USERAS\Desktop\Projects\CSharp\PortfolioProject\TechtonicFramework\packages\Microsoft.AspNet.Identity.Owin.2.2.4\lib\net45\Microsoft.AspNet.Identity.Owin.xml", "XML", -642, 0, 0, 0, 0, -1, -643
"c:\Users\USERAS\Desktop\Projects\CSharp\PortfolioProject\TechtonicFramework\packages\Microsoft.AspNet.Mvc.5.3.0\lib\net45\System.Web.Mvc.xml", "XML", -11485, 0, 0, 0, 0, 0, -11485
"c:\Users\USERAS\Desktop\Projects\CSharp\PortfolioProject\TechtonicFramework\packages\Microsoft.AspNet.Razor.3.3.0\lib\net45\System.Web.Razor.xml", "XML", -5742, 0, 0, 0, 0, 0, -5742
"c:\Users\USERAS\Desktop\Projects\CSharp\PortfolioProject\TechtonicFramework\packages\Microsoft.AspNet.Web.Optimization.1.1.3\lib\net40\system.web.optimization.xml", "XML", -666, 0, 0, 0, 0, 0, -666
"c:\Users\USERAS\Desktop\Projects\CSharp\PortfolioProject\TechtonicFramework\packages\Microsoft.AspNet.WebApi.Client.5.2.9\lib\net45\System.Net.Http.Formatting.xml", "XML", -2094, 0, 0, 0, 0, 0, -2094
"c:\Users\USERAS\Desktop\Projects\CSharp\PortfolioProject\TechtonicFramework\packages\Microsoft.AspNet.WebApi.Client.5.2.9\lib\netstandard2.0\System.Net.Http.Formatting.xml", "XML", -4025, 0, 0, 0, 0, -1, -4026
"c:\Users\USERAS\Desktop\Projects\CSharp\PortfolioProject\TechtonicFramework\packages\Microsoft.AspNet.WebApi.Client.5.2.9\lib\portable-wp8+netcore45+net45+wp81+wpa81\System.Net.Http.Formatting.xml", "XML", -4025, 0, 0, 0, 0, -1, -4026
"c:\Users\USERAS\Desktop\Projects\CSharp\PortfolioProject\TechtonicFramework\packages\Microsoft.AspNet.WebApi.Core.5.2.9\lib\net45\System.Web.Http.xml", "XML", -6664, 0, 0, 0, 0, 0, -6664
"c:\Users\USERAS\Desktop\Projects\CSharp\PortfolioProject\TechtonicFramework\packages\Microsoft.AspNet.WebApi.Cors.5.2.9\lib\net45\System.Web.Http.Cors.xml", "XML", -179, 0, 0, 0, 0, 0, -179
"c:\Users\USERAS\Desktop\Projects\CSharp\PortfolioProject\TechtonicFramework\packages\Microsoft.AspNet.WebApi.Cors.5.3.0\lib\net45\System.Web.Http.Cors.xml", "XML", -179, 0, 0, 0, 0, 0, -179
"c:\Users\USERAS\Desktop\Projects\CSharp\PortfolioProject\TechtonicFramework\packages\Microsoft.AspNet.WebApi.Owin.5.2.9\lib\net45\System.Web.Http.Owin.xml", "XML", -195, 0, 0, 0, 0, 0, -195
"c:\Users\USERAS\Desktop\Projects\CSharp\PortfolioProject\TechtonicFramework\packages\Microsoft.AspNet.WebApi.WebHost.5.2.9\lib\net45\System.Web.Http.WebHost.xml", "XML", -135, 0, 0, 0, 0, 0, -135
"c:\Users\USERAS\Desktop\Projects\CSharp\PortfolioProject\TechtonicFramework\packages\Microsoft.AspNet.WebApi.WebHost.5.3.0\lib\net45\System.Web.Http.WebHost.xml", "XML", -135, 0, 0, 0, 0, 0, -135
"c:\Users\USERAS\Desktop\Projects\CSharp\PortfolioProject\TechtonicFramework\packages\Microsoft.AspNet.WebPages.3.3.0\lib\net45\System.Web.Helpers.xml", "XML", -839, 0, 0, 0, 0, 0, -839
"c:\Users\USERAS\Desktop\Projects\CSharp\PortfolioProject\TechtonicFramework\packages\Microsoft.AspNet.WebPages.3.3.0\lib\net45\System.Web.WebPages.Deployment.xml", "XML", -60, 0, 0, 0, 0, 0, -60
"c:\Users\USERAS\Desktop\Projects\CSharp\PortfolioProject\TechtonicFramework\packages\Microsoft.AspNet.WebPages.3.3.0\lib\net45\System.Web.WebPages.Razor.xml", "XML", -292, 0, 0, 0, 0, 0, -292
"c:\Users\USERAS\Desktop\Projects\CSharp\PortfolioProject\TechtonicFramework\packages\Microsoft.AspNet.WebPages.3.3.0\lib\net45\System.Web.WebPages.xml", "XML", -2706, 0, 0, 0, 0, 0, -2706
"c:\Users\USERAS\Desktop\Projects\CSharp\PortfolioProject\TechtonicFramework\packages\Microsoft.AspNetCore.Cors.2.3.0\lib\netstandard2.0\Microsoft.AspNetCore.Cors.xml", "XML", -551, 0, 0, 0, 0, -1, -552
"c:\Users\USERAS\Desktop\Projects\CSharp\PortfolioProject\TechtonicFramework\packages\Microsoft.CodeDom.Providers.DotNetCompilerPlatform.2.0.1\build\net45\Microsoft.CodeDom.Providers.DotNetCompilerPlatform.Extensions.props", "XML", -5, 0, 0, 0, 0, 0, -5
"c:\Users\USERAS\Desktop\Projects\CSharp\PortfolioProject\TechtonicFramework\packages\Microsoft.CodeDom.Providers.DotNetCompilerPlatform.2.0.1\build\net45\Microsoft.CodeDom.Providers.DotNetCompilerPlatform.props", "XML", -109, 0, 0, 0, 0, -2, -111
"c:\Users\USERAS\Desktop\Projects\CSharp\PortfolioProject\TechtonicFramework\packages\Microsoft.CodeDom.Providers.DotNetCompilerPlatform.2.0.1\build\net46\Microsoft.CodeDom.Providers.DotNetCompilerPlatform.Extensions.props", "XML", -5, 0, 0, 0, 0, 0, -5
"c:\Users\USERAS\Desktop\Projects\CSharp\PortfolioProject\TechtonicFramework\packages\Microsoft.CodeDom.Providers.DotNetCompilerPlatform.2.0.1\build\net46\Microsoft.CodeDom.Providers.DotNetCompilerPlatform.props", "XML", -109, 0, 0, 0, 0, -2, -111
"c:\Users\USERAS\Desktop\Projects\CSharp\PortfolioProject\TechtonicFramework\packages\Microsoft.CodeDom.Providers.DotNetCompilerPlatform.2.0.1\lib\net45\Microsoft.CodeDom.Providers.DotNetCompilerPlatform.xml", "XML", -67, 0, 0, 0, 0, -1, -68
"c:\Users\USERAS\Desktop\Projects\CSharp\PortfolioProject\TechtonicFramework\packages\Microsoft.CodeDom.Providers.DotNetCompilerPlatform.2.0.1\tools\Roslyn45\Microsoft.CSharp.Core.targets", "XML", -126, 0, 0, 0, -9, -11, -146
"c:\Users\USERAS\Desktop\Projects\CSharp\PortfolioProject\TechtonicFramework\packages\Microsoft.CodeDom.Providers.DotNetCompilerPlatform.2.0.1\tools\Roslyn45\Microsoft.VisualBasic.Core.targets", "XML", -132, 0, 0, 0, -3, -8, -143
"c:\Users\USERAS\Desktop\Projects\CSharp\PortfolioProject\TechtonicFramework\packages\Microsoft.CodeDom.Providers.DotNetCompilerPlatform.2.0.1\tools\RoslynLatest\Microsoft.CSharp.Core.targets", "XML", -119, 0, 0, 0, -9, -7, -135
"c:\Users\USERAS\Desktop\Projects\CSharp\PortfolioProject\TechtonicFramework\packages\Microsoft.CodeDom.Providers.DotNetCompilerPlatform.2.0.1\tools\RoslynLatest\Microsoft.Managed.Core.targets", "XML", -63, 0, 0, 0, -71, -21, -155
"c:\Users\USERAS\Desktop\Projects\CSharp\PortfolioProject\TechtonicFramework\packages\Microsoft.CodeDom.Providers.DotNetCompilerPlatform.2.0.1\tools\RoslynLatest\Microsoft.VisualBasic.Core.targets", "XML", -125, 0, 0, 0, -3, -4, -132
"c:\Users\USERAS\Desktop\Projects\CSharp\PortfolioProject\TechtonicFramework\packages\Microsoft.CodeDom.Providers.DotNetCompilerPlatform.2.0.1\tools\net45\install.ps1", "PowerShell", 0, 0, -55, 0, -205, -12, -272
"c:\Users\USERAS\Desktop\Projects\CSharp\PortfolioProject\TechtonicFramework\packages\Microsoft.CodeDom.Providers.DotNetCompilerPlatform.2.0.1\tools\net45\uninstall.ps1", "PowerShell", 0, 0, -12, 0, -198, -6, -216
"c:\Users\USERAS\Desktop\Projects\CSharp\PortfolioProject\TechtonicFramework\packages\Microsoft.Extensions.Configuration.Abstractions.8.0.0\PACKAGE.md", "Markdown", 0, -50, 0, 0, -7, -26, -83
"c:\Users\USERAS\Desktop\Projects\CSharp\PortfolioProject\TechtonicFramework\packages\Microsoft.Extensions.Configuration.Abstractions.8.0.0\buildTransitive\net461\Microsoft.Extensions.Configuration.Abstractions.targets", "XML", -6, 0, 0, 0, 0, -1, -7
"c:\Users\USERAS\Desktop\Projects\CSharp\PortfolioProject\TechtonicFramework\packages\Microsoft.Extensions.Configuration.Abstractions.8.0.0\buildTransitive\netcoreapp2.0\Microsoft.Extensions.Configuration.Abstractions.targets", "XML", -6, 0, 0, 0, 0, -1, -7
"c:\Users\USERAS\Desktop\Projects\CSharp\PortfolioProject\TechtonicFramework\packages\Microsoft.Extensions.Configuration.Abstractions.8.0.0\lib\net462\Microsoft.Extensions.Configuration.Abstractions.xml", "XML", -534, 0, 0, 0, 0, -1, -535
"c:\Users\USERAS\Desktop\Projects\CSharp\PortfolioProject\TechtonicFramework\packages\Microsoft.Extensions.Configuration.Abstractions.8.0.0\lib\net6.0\Microsoft.Extensions.Configuration.Abstractions.xml", "XML", -425, 0, 0, 0, 0, -1, -426
"c:\Users\USERAS\Desktop\Projects\CSharp\PortfolioProject\TechtonicFramework\packages\Microsoft.Extensions.Configuration.Abstractions.8.0.0\lib\net7.0\Microsoft.Extensions.Configuration.Abstractions.xml", "XML", -354, 0, 0, 0, 0, -1, -355
"c:\Users\USERAS\Desktop\Projects\CSharp\PortfolioProject\TechtonicFramework\packages\Microsoft.Extensions.Configuration.Abstractions.8.0.0\lib\net8.0\Microsoft.Extensions.Configuration.Abstractions.xml", "XML", -354, 0, 0, 0, 0, -1, -355
"c:\Users\USERAS\Desktop\Projects\CSharp\PortfolioProject\TechtonicFramework\packages\Microsoft.Extensions.Configuration.Abstractions.8.0.0\lib\netstandard2.0\Microsoft.Extensions.Configuration.Abstractions.xml", "XML", -534, 0, 0, 0, 0, -1, -535
"c:\Users\USERAS\Desktop\Projects\CSharp\PortfolioProject\TechtonicFramework\packages\Microsoft.Owin.4.2.2\lib\net45\Microsoft.Owin.xml", "XML", -3298, 0, 0, 0, 0, -19, -3317
"c:\Users\USERAS\Desktop\Projects\CSharp\PortfolioProject\TechtonicFramework\packages\Microsoft.Owin.Cors.4.2.2\lib\net45\Microsoft.Owin.Cors.xml", "XML", -96, 0, 0, 0, 0, -1, -97
"c:\Users\USERAS\Desktop\Projects\CSharp\PortfolioProject\TechtonicFramework\packages\Microsoft.Owin.Host.SystemWeb.4.2.2\lib\net45\Microsoft.Owin.Host.SystemWeb.xml", "XML", -635, 0, 0, 0, 0, -5, -640
"c:\Users\USERAS\Desktop\Projects\CSharp\PortfolioProject\TechtonicFramework\packages\Microsoft.Owin.Security.4.2.2\lib\net45\Microsoft.Owin.Security.xml", "XML", -493, 0, 0, 0, 0, -2, -495
"c:\Users\USERAS\Desktop\Projects\CSharp\PortfolioProject\TechtonicFramework\packages\Microsoft.Owin.Security.Cookies.4.2.2\lib\net45\Microsoft.Owin.Security.Cookies.xml", "XML", -548, 0, 0, 0, 0, -4, -552
"c:\Users\USERAS\Desktop\Projects\CSharp\PortfolioProject\TechtonicFramework\packages\Microsoft.Owin.Security.OAuth.3.0.1\lib\net45\Microsoft.Owin.Security.OAuth.XML", "XML", -1637, 0, 0, 0, 0, -1, -1638
"c:\Users\USERAS\Desktop\Projects\CSharp\PortfolioProject\TechtonicFramework\packages\Newtonsoft.Json.13.0.3\LICENSE.md", "Markdown", 0, -16, 0, 0, 0, -5, -21
"c:\Users\USERAS\Desktop\Projects\CSharp\PortfolioProject\TechtonicFramework\packages\Newtonsoft.Json.13.0.3\README.md", "Markdown", 0, -56, 0, 0, 0, -16, -72
"c:\Users\USERAS\Desktop\Projects\CSharp\PortfolioProject\TechtonicFramework\packages\Newtonsoft.Json.13.0.3\lib\net20\Newtonsoft.Json.xml", "XML", -10393, 0, 0, 0, 0, -1, -10394
"c:\Users\USERAS\Desktop\Projects\CSharp\PortfolioProject\TechtonicFramework\packages\Newtonsoft.Json.13.0.3\lib\net35\Newtonsoft.Json.xml", "XML", -9541, 0, 0, 0, 0, -1, -9542
"c:\Users\USERAS\Desktop\Projects\CSharp\PortfolioProject\TechtonicFramework\packages\Newtonsoft.Json.13.0.3\lib\net40\Newtonsoft.Json.xml", "XML", -9741, 0, 0, 0, 0, -1, -9742
"c:\Users\USERAS\Desktop\Projects\CSharp\PortfolioProject\TechtonicFramework\packages\Newtonsoft.Json.13.0.3\lib\net45\Newtonsoft.Json.xml", "XML", -11363, 0, 0, 0, 0, -1, -11364
"c:\Users\USERAS\Desktop\Projects\CSharp\PortfolioProject\TechtonicFramework\packages\Newtonsoft.Json.13.0.3\lib\net6.0\Newtonsoft.Json.xml", "XML", -11325, 0, 0, 0, 0, -1, -11326
"c:\Users\USERAS\Desktop\Projects\CSharp\PortfolioProject\TechtonicFramework\packages\Newtonsoft.Json.13.0.3\lib\netstandard1.0\Newtonsoft.Json.xml", "XML", -11050, 0, 0, 0, 0, -2, -11052
"c:\Users\USERAS\Desktop\Projects\CSharp\PortfolioProject\TechtonicFramework\packages\Newtonsoft.Json.13.0.3\lib\netstandard1.3\Newtonsoft.Json.xml", "XML", -11172, 0, 0, 0, 0, -2, -11174
"c:\Users\USERAS\Desktop\Projects\CSharp\PortfolioProject\TechtonicFramework\packages\Newtonsoft.Json.13.0.3\lib\netstandard2.0\Newtonsoft.Json.xml", "XML", -11338, 0, 0, 0, 0, -1, -11339
"c:\Users\USERAS\Desktop\Projects\CSharp\PortfolioProject\TechtonicFramework\packages\Newtonsoft.Json.Bson.1.0.2\LICENSE.md", "Markdown", 0, -16, 0, 0, 0, -5, -21
"c:\Users\USERAS\Desktop\Projects\CSharp\PortfolioProject\TechtonicFramework\packages\Newtonsoft.Json.Bson.1.0.2\lib\net45\Newtonsoft.Json.Bson.xml", "XML", -545, 0, 0, 0, 0, -1, -546
"c:\Users\USERAS\Desktop\Projects\CSharp\PortfolioProject\TechtonicFramework\packages\Newtonsoft.Json.Bson.1.0.2\lib\netstandard1.3\Newtonsoft.Json.Bson.xml", "XML", -545, 0, 0, 0, 0, -1, -546
"c:\Users\USERAS\Desktop\Projects\CSharp\PortfolioProject\TechtonicFramework\packages\Newtonsoft.Json.Bson.1.0.2\lib\netstandard2.0\Newtonsoft.Json.Bson.xml", "XML", -545, 0, 0, 0, 0, -1, -546
"c:\Users\USERAS\Desktop\Projects\CSharp\PortfolioProject\TechtonicFramework\packages\System.Buffers.4.5.1\lib\net461\System.Buffers.xml", "XML", -38, 0, 0, 0, 0, 0, -38
"c:\Users\USERAS\Desktop\Projects\CSharp\PortfolioProject\TechtonicFramework\packages\System.Buffers.4.5.1\lib\netstandard1.1\System.Buffers.xml", "XML", -38, 0, 0, 0, 0, 0, -38
"c:\Users\USERAS\Desktop\Projects\CSharp\PortfolioProject\TechtonicFramework\packages\System.Buffers.4.5.1\lib\netstandard2.0\System.Buffers.xml", "XML", -38, 0, 0, 0, 0, 0, -38
"c:\Users\USERAS\Desktop\Projects\CSharp\PortfolioProject\TechtonicFramework\packages\System.Buffers.4.5.1\ref\net45\System.Buffers.xml", "XML", -38, 0, 0, 0, 0, 0, -38
"c:\Users\USERAS\Desktop\Projects\CSharp\PortfolioProject\TechtonicFramework\packages\System.Buffers.4.5.1\ref\netstandard1.1\System.Buffers.xml", "XML", -38, 0, 0, 0, 0, 0, -38
"c:\Users\USERAS\Desktop\Projects\CSharp\PortfolioProject\TechtonicFramework\packages\System.Buffers.4.5.1\ref\netstandard2.0\System.Buffers.xml", "XML", -38, 0, 0, 0, 0, 0, -38
"c:\Users\USERAS\Desktop\Projects\CSharp\PortfolioProject\TechtonicFramework\packages\System.Data.SqlClient.4.9.0\PACKAGE.md", "Markdown", 0, -24, 0, 0, 0, -11, -35
"c:\Users\USERAS\Desktop\Projects\CSharp\PortfolioProject\TechtonicFramework\packages\System.Data.SqlClient.4.9.0\buildTransitive\net461\System.Data.SqlClient.targets", "XML", -6, 0, 0, 0, 0, -1, -7
"c:\Users\USERAS\Desktop\Projects\CSharp\PortfolioProject\TechtonicFramework\packages\System.Data.SqlClient.4.9.0\buildTransitive\netcoreapp2.0\System.Data.SqlClient.targets", "XML", -6, 0, 0, 0, 0, -1, -7
"c:\Users\USERAS\Desktop\Projects\CSharp\PortfolioProject\TechtonicFramework\packages\System.Data.SqlClient.4.9.0\lib\net462\System.Data.SqlClient.xml", "XML", -3563, 0, 0, 0, 0, -13, -3576
"c:\Users\USERAS\Desktop\Projects\CSharp\PortfolioProject\TechtonicFramework\packages\System.Data.SqlClient.4.9.0\lib\net6.0\System.Data.SqlClient.xml", "XML", -3563, 0, 0, 0, 0, -13, -3576
"c:\Users\USERAS\Desktop\Projects\CSharp\PortfolioProject\TechtonicFramework\packages\System.Data.SqlClient.4.9.0\lib\net8.0\System.Data.SqlClient.xml", "XML", -3563, 0, 0, 0, 0, -13, -3576
"c:\Users\USERAS\Desktop\Projects\CSharp\PortfolioProject\TechtonicFramework\packages\System.Data.SqlClient.4.9.0\lib\netstandard2.0\System.Data.SqlClient.xml", "XML", -3563, 0, 0, 0, 0, -13, -3576
"c:\Users\USERAS\Desktop\Projects\CSharp\PortfolioProject\TechtonicFramework\packages\System.Data.SqlClient.4.9.0\runtimes\unix\lib\net6.0\System.Data.SqlClient.xml", "XML", -3563, 0, 0, 0, 0, -13, -3576
"c:\Users\USERAS\Desktop\Projects\CSharp\PortfolioProject\TechtonicFramework\packages\System.Data.SqlClient.4.9.0\runtimes\unix\lib\net8.0\System.Data.SqlClient.xml", "XML", -3563, 0, 0, 0, 0, -13, -3576
"c:\Users\USERAS\Desktop\Projects\CSharp\PortfolioProject\TechtonicFramework\packages\System.Data.SqlClient.4.9.0\runtimes\win\lib\net6.0\System.Data.SqlClient.xml", "XML", -3563, 0, 0, 0, 0, -13, -3576
"c:\Users\USERAS\Desktop\Projects\CSharp\PortfolioProject\TechtonicFramework\packages\System.Data.SqlClient.4.9.0\runtimes\win\lib\net8.0\System.Data.SqlClient.xml", "XML", -3563, 0, 0, 0, 0, -13, -3576
"c:\Users\USERAS\Desktop\Projects\CSharp\PortfolioProject\TechtonicFramework\packages\System.IO.4.3.0\ref\netcore50\System.IO.xml", "XML", -2151, 0, 0, 0, 0, 0, -2151
"c:\Users\USERAS\Desktop\Projects\CSharp\PortfolioProject\TechtonicFramework\packages\System.IO.4.3.0\ref\netcore50\de\System.IO.xml", "XML", -2151, 0, 0, 0, 0, 0, -2151
"c:\Users\USERAS\Desktop\Projects\CSharp\PortfolioProject\TechtonicFramework\packages\System.IO.4.3.0\ref\netcore50\es\System.IO.xml", "XML", -2090, 0, 0, 0, 0, 0, -2090
"c:\Users\USERAS\Desktop\Projects\CSharp\PortfolioProject\TechtonicFramework\packages\System.IO.4.3.0\ref\netcore50\fr\System.IO.xml", "XML", -2201, 0, 0, 0, 0, 0, -2201
"c:\Users\USERAS\Desktop\Projects\CSharp\PortfolioProject\TechtonicFramework\packages\System.IO.4.3.0\ref\netcore50\it\System.IO.xml", "XML", -2123, 0, 0, 0, 0, 0, -2123
"c:\Users\USERAS\Desktop\Projects\CSharp\PortfolioProject\TechtonicFramework\packages\System.IO.4.3.0\ref\netcore50\ja\System.IO.xml", "XML", -2264, 0, 0, 0, 0, 0, -2264
"c:\Users\USERAS\Desktop\Projects\CSharp\PortfolioProject\TechtonicFramework\packages\System.IO.4.3.0\ref\netcore50\ko\System.IO.xml", "XML", -2262, 0, 0, 0, 0, 0, -2262
"c:\Users\USERAS\Desktop\Projects\CSharp\PortfolioProject\TechtonicFramework\packages\System.IO.4.3.0\ref\netcore50\ru\System.IO.xml", "XML", -2023, 0, 0, 0, 0, 0, -2023
"c:\Users\USERAS\Desktop\Projects\CSharp\PortfolioProject\TechtonicFramework\packages\System.IO.4.3.0\ref\netcore50\zh-hans\System.IO.xml", "XML", -2237, 0, 0, 0, 0, 0, -2237
"c:\Users\USERAS\Desktop\Projects\CSharp\PortfolioProject\TechtonicFramework\packages\System.IO.4.3.0\ref\netcore50\zh-hant\System.IO.xml", "XML", -2246, 0, 0, 0, 0, 0, -2246
"c:\Users\USERAS\Desktop\Projects\CSharp\PortfolioProject\TechtonicFramework\packages\System.IO.4.3.0\ref\netstandard1.0\System.IO.xml", "XML", -2151, 0, 0, 0, 0, 0, -2151
"c:\Users\USERAS\Desktop\Projects\CSharp\PortfolioProject\TechtonicFramework\packages\System.IO.4.3.0\ref\netstandard1.0\de\System.IO.xml", "XML", -2151, 0, 0, 0, 0, 0, -2151
"c:\Users\USERAS\Desktop\Projects\CSharp\PortfolioProject\TechtonicFramework\packages\System.IO.4.3.0\ref\netstandard1.0\es\System.IO.xml", "XML", -2090, 0, 0, 0, 0, 0, -2090
"c:\Users\USERAS\Desktop\Projects\CSharp\PortfolioProject\TechtonicFramework\packages\System.IO.4.3.0\ref\netstandard1.0\fr\System.IO.xml", "XML", -2201, 0, 0, 0, 0, 0, -2201
"c:\Users\USERAS\Desktop\Projects\CSharp\PortfolioProject\TechtonicFramework\packages\System.IO.4.3.0\ref\netstandard1.0\it\System.IO.xml", "XML", -2123, 0, 0, 0, 0, 0, -2123
"c:\Users\USERAS\Desktop\Projects\CSharp\PortfolioProject\TechtonicFramework\packages\System.IO.4.3.0\ref\netstandard1.0\ja\System.IO.xml", "XML", -2264, 0, 0, 0, 0, 0, -2264
"c:\Users\USERAS\Desktop\Projects\CSharp\PortfolioProject\TechtonicFramework\packages\System.IO.4.3.0\ref\netstandard1.0\ko\System.IO.xml", "XML", -2262, 0, 0, 0, 0, 0, -2262
"c:\Users\USERAS\Desktop\Projects\CSharp\PortfolioProject\TechtonicFramework\packages\System.IO.4.3.0\ref\netstandard1.0\ru\System.IO.xml", "XML", -2023, 0, 0, 0, 0, 0, -2023
"c:\Users\USERAS\Desktop\Projects\CSharp\PortfolioProject\TechtonicFramework\packages\System.IO.4.3.0\ref\netstandard1.0\zh-hans\System.IO.xml", "XML", -2237, 0, 0, 0, 0, 0, -2237
"c:\Users\USERAS\Desktop\Projects\CSharp\PortfolioProject\TechtonicFramework\packages\System.IO.4.3.0\ref\netstandard1.0\zh-hant\System.IO.xml", "XML", -2246, 0, 0, 0, 0, 0, -2246
"c:\Users\USERAS\Desktop\Projects\CSharp\PortfolioProject\TechtonicFramework\packages\System.IO.4.3.0\ref\netstandard1.3\System.IO.xml", "XML", -2151, 0, 0, 0, 0, 0, -2151
"c:\Users\USERAS\Desktop\Projects\CSharp\PortfolioProject\TechtonicFramework\packages\System.IO.4.3.0\ref\netstandard1.3\de\System.IO.xml", "XML", -2151, 0, 0, 0, 0, 0, -2151
"c:\Users\USERAS\Desktop\Projects\CSharp\PortfolioProject\TechtonicFramework\packages\System.IO.4.3.0\ref\netstandard1.3\es\System.IO.xml", "XML", -2090, 0, 0, 0, 0, 0, -2090
"c:\Users\USERAS\Desktop\Projects\CSharp\PortfolioProject\TechtonicFramework\packages\System.IO.4.3.0\ref\netstandard1.3\fr\System.IO.xml", "XML", -2201, 0, 0, 0, 0, 0, -2201
"c:\Users\USERAS\Desktop\Projects\CSharp\PortfolioProject\TechtonicFramework\packages\System.IO.4.3.0\ref\netstandard1.3\it\System.IO.xml", "XML", -2123, 0, 0, 0, 0, 0, -2123
"c:\Users\USERAS\Desktop\Projects\CSharp\PortfolioProject\TechtonicFramework\packages\System.IO.4.3.0\ref\netstandard1.3\ja\System.IO.xml", "XML", -2264, 0, 0, 0, 0, 0, -2264
"c:\Users\USERAS\Desktop\Projects\CSharp\PortfolioProject\TechtonicFramework\packages\System.IO.4.3.0\ref\netstandard1.3\ko\System.IO.xml", "XML", -2262, 0, 0, 0, 0, 0, -2262
"c:\Users\USERAS\Desktop\Projects\CSharp\PortfolioProject\TechtonicFramework\packages\System.IO.4.3.0\ref\netstandard1.3\ru\System.IO.xml", "XML", -2023, 0, 0, 0, 0, 0, -2023
"c:\Users\USERAS\Desktop\Projects\CSharp\PortfolioProject\TechtonicFramework\packages\System.IO.4.3.0\ref\netstandard1.3\zh-hans\System.IO.xml", "XML", -2237, 0, 0, 0, 0, 0, -2237
"c:\Users\USERAS\Desktop\Projects\CSharp\PortfolioProject\TechtonicFramework\packages\System.IO.4.3.0\ref\netstandard1.3\zh-hant\System.IO.xml", "XML", -2246, 0, 0, 0, 0, 0, -2246
"c:\Users\USERAS\Desktop\Projects\CSharp\PortfolioProject\TechtonicFramework\packages\System.IO.4.3.0\ref\netstandard1.5\System.IO.xml", "XML", -2151, 0, 0, 0, 0, 0, -2151
"c:\Users\USERAS\Desktop\Projects\CSharp\PortfolioProject\TechtonicFramework\packages\System.IO.4.3.0\ref\netstandard1.5\de\System.IO.xml", "XML", -2151, 0, 0, 0, 0, 0, -2151
"c:\Users\USERAS\Desktop\Projects\CSharp\PortfolioProject\TechtonicFramework\packages\System.IO.4.3.0\ref\netstandard1.5\es\System.IO.xml", "XML", -2090, 0, 0, 0, 0, 0, -2090
"c:\Users\USERAS\Desktop\Projects\CSharp\PortfolioProject\TechtonicFramework\packages\System.IO.4.3.0\ref\netstandard1.5\fr\System.IO.xml", "XML", -2201, 0, 0, 0, 0, 0, -2201
"c:\Users\USERAS\Desktop\Projects\CSharp\PortfolioProject\TechtonicFramework\packages\System.IO.4.3.0\ref\netstandard1.5\it\System.IO.xml", "XML", -2123, 0, 0, 0, 0, 0, -2123
"c:\Users\USERAS\Desktop\Projects\CSharp\PortfolioProject\TechtonicFramework\packages\System.IO.4.3.0\ref\netstandard1.5\ja\System.IO.xml", "XML", -2264, 0, 0, 0, 0, 0, -2264
"c:\Users\USERAS\Desktop\Projects\CSharp\PortfolioProject\TechtonicFramework\packages\System.IO.4.3.0\ref\netstandard1.5\ko\System.IO.xml", "XML", -2262, 0, 0, 0, 0, 0, -2262
"c:\Users\USERAS\Desktop\Projects\CSharp\PortfolioProject\TechtonicFramework\packages\System.IO.4.3.0\ref\netstandard1.5\ru\System.IO.xml", "XML", -2023, 0, 0, 0, 0, 0, -2023
"c:\Users\USERAS\Desktop\Projects\CSharp\PortfolioProject\TechtonicFramework\packages\System.IO.4.3.0\ref\netstandard1.5\zh-hans\System.IO.xml", "XML", -2237, 0, 0, 0, 0, 0, -2237
"c:\Users\USERAS\Desktop\Projects\CSharp\PortfolioProject\TechtonicFramework\packages\System.IO.4.3.0\ref\netstandard1.5\zh-hant\System.IO.xml", "XML", -2246, 0, 0, 0, 0, 0, -2246
"c:\Users\USERAS\Desktop\Projects\CSharp\PortfolioProject\TechtonicFramework\packages\System.Memory.4.5.3\lib\netstandard1.1\System.Memory.xml", "XML", -353, 0, 0, 0, 0, -2, -355
"c:\Users\USERAS\Desktop\Projects\CSharp\PortfolioProject\TechtonicFramework\packages\System.Memory.4.5.3\lib\netstandard2.0\System.Memory.xml", "XML", -353, 0, 0, 0, 0, -2, -355
"c:\Users\USERAS\Desktop\Projects\CSharp\PortfolioProject\TechtonicFramework\packages\System.Numerics.Vectors.4.5.0\lib\net46\System.Numerics.Vectors.xml", "XML", -2621, 0, 0, 0, 0, 0, -2621
"c:\Users\USERAS\Desktop\Projects\CSharp\PortfolioProject\TechtonicFramework\packages\System.Numerics.Vectors.4.5.0\lib\netstandard1.0\System.Numerics.Vectors.xml", "XML", -2621, 0, 0, 0, 0, 0, -2621
"c:\Users\USERAS\Desktop\Projects\CSharp\PortfolioProject\TechtonicFramework\packages\System.Numerics.Vectors.4.5.0\lib\netstandard2.0\System.Numerics.Vectors.xml", "XML", -2621, 0, 0, 0, 0, 0, -2621
"c:\Users\USERAS\Desktop\Projects\CSharp\PortfolioProject\TechtonicFramework\packages\System.Numerics.Vectors.4.5.0\lib\portable-net45+win8+wp8+wpa81\System.Numerics.Vectors.xml", "XML", -2621, 0, 0, 0, 0, 0, -2621
"c:\Users\USERAS\Desktop\Projects\CSharp\PortfolioProject\TechtonicFramework\packages\System.Numerics.Vectors.4.5.0\ref\net45\System.Numerics.Vectors.xml", "XML", -2621, 0, 0, 0, 0, 0, -2621
"c:\Users\USERAS\Desktop\Projects\CSharp\PortfolioProject\TechtonicFramework\packages\System.Numerics.Vectors.4.5.0\ref\net46\System.Numerics.Vectors.xml", "XML", -2621, 0, 0, 0, 0, 0, -2621
"c:\Users\USERAS\Desktop\Projects\CSharp\PortfolioProject\TechtonicFramework\packages\System.Numerics.Vectors.4.5.0\ref\netstandard1.0\System.Numerics.Vectors.xml", "XML", -2621, 0, 0, 0, 0, 0, -2621
"c:\Users\USERAS\Desktop\Projects\CSharp\PortfolioProject\TechtonicFramework\packages\System.Numerics.Vectors.4.5.0\ref\netstandard2.0\System.Numerics.Vectors.xml", "XML", -2621, 0, 0, 0, 0, 0, -2621
"c:\Users\USERAS\Desktop\Projects\CSharp\PortfolioProject\TechtonicFramework\packages\System.Runtime.4.3.0\ref\netcore50\System.Runtime.xml", "XML", -15642, 0, 0, 0, 0, 0, -15642
"c:\Users\USERAS\Desktop\Projects\CSharp\PortfolioProject\TechtonicFramework\packages\System.Runtime.4.3.0\ref\netcore50\de\System.Runtime.xml", "XML", -15647, 0, 0, 0, 0, 0, -15647
"c:\Users\USERAS\Desktop\Projects\CSharp\PortfolioProject\TechtonicFramework\packages\System.Runtime.4.3.0\ref\netcore50\es\System.Runtime.xml", "XML", -15620, 0, 0, 0, 0, 0, -15620
"c:\Users\USERAS\Desktop\Projects\CSharp\PortfolioProject\TechtonicFramework\packages\System.Runtime.4.3.0\ref\netcore50\fr\System.Runtime.xml", "XML", -15856, 0, 0, 0, 0, 0, -15856
"c:\Users\USERAS\Desktop\Projects\CSharp\PortfolioProject\TechtonicFramework\packages\System.Runtime.4.3.0\ref\netcore50\it\System.Runtime.xml", "XML", -15649, 0, 0, 0, 0, 0, -15649
"c:\Users\USERAS\Desktop\Projects\CSharp\PortfolioProject\TechtonicFramework\packages\System.Runtime.4.3.0\ref\netcore50\ja\System.Runtime.xml", "XML", -16970, 0, 0, 0, 0, 0, -16970
"c:\Users\USERAS\Desktop\Projects\CSharp\PortfolioProject\TechtonicFramework\packages\System.Runtime.4.3.0\ref\netcore50\ko\System.Runtime.xml", "XML", -16922, 0, 0, 0, 0, 0, -16922
"c:\Users\USERAS\Desktop\Projects\CSharp\PortfolioProject\TechtonicFramework\packages\System.Runtime.4.3.0\ref\netcore50\ru\System.Runtime.xml", "XML", -15262, 0, 0, 0, 0, 0, -15262
"c:\Users\USERAS\Desktop\Projects\CSharp\PortfolioProject\TechtonicFramework\packages\System.Runtime.4.3.0\ref\netcore50\zh-hans\System.Runtime.xml", "XML", -15922, 0, 0, 0, 0, 0, -15922
"c:\Users\USERAS\Desktop\Projects\CSharp\PortfolioProject\TechtonicFramework\packages\System.Runtime.4.3.0\ref\netcore50\zh-hant\System.Runtime.xml", "XML", -15977, 0, 0, 0, 0, 0, -15977
"c:\Users\USERAS\Desktop\Projects\CSharp\PortfolioProject\TechtonicFramework\packages\System.Runtime.4.3.0\ref\netstandard1.0\System.Runtime.xml", "XML", -15642, 0, 0, 0, 0, 0, -15642
"c:\Users\USERAS\Desktop\Projects\CSharp\PortfolioProject\TechtonicFramework\packages\System.Runtime.4.3.0\ref\netstandard1.0\de\System.Runtime.xml", "XML", -15647, 0, 0, 0, 0, 0, -15647
"c:\Users\USERAS\Desktop\Projects\CSharp\PortfolioProject\TechtonicFramework\packages\System.Runtime.4.3.0\ref\netstandard1.0\es\System.Runtime.xml", "XML", -15620, 0, 0, 0, 0, 0, -15620
"c:\Users\USERAS\Desktop\Projects\CSharp\PortfolioProject\TechtonicFramework\packages\System.Runtime.4.3.0\ref\netstandard1.0\fr\System.Runtime.xml", "XML", -15856, 0, 0, 0, 0, 0, -15856
"c:\Users\USERAS\Desktop\Projects\CSharp\PortfolioProject\TechtonicFramework\packages\System.Runtime.4.3.0\ref\netstandard1.0\it\System.Runtime.xml", "XML", -15649, 0, 0, 0, 0, 0, -15649
"c:\Users\USERAS\Desktop\Projects\CSharp\PortfolioProject\TechtonicFramework\packages\System.Runtime.4.3.0\ref\netstandard1.0\ja\System.Runtime.xml", "XML", -16970, 0, 0, 0, 0, 0, -16970
"c:\Users\USERAS\Desktop\Projects\CSharp\PortfolioProject\TechtonicFramework\packages\System.Runtime.4.3.0\ref\netstandard1.0\ko\System.Runtime.xml", "XML", -16922, 0, 0, 0, 0, 0, -16922
"c:\Users\USERAS\Desktop\Projects\CSharp\PortfolioProject\TechtonicFramework\packages\System.Runtime.4.3.0\ref\netstandard1.0\ru\System.Runtime.xml", "XML", -15262, 0, 0, 0, 0, 0, -15262
"c:\Users\USERAS\Desktop\Projects\CSharp\PortfolioProject\TechtonicFramework\packages\System.Runtime.4.3.0\ref\netstandard1.0\zh-hans\System.Runtime.xml", "XML", -15922, 0, 0, 0, 0, 0, -15922
"c:\Users\USERAS\Desktop\Projects\CSharp\PortfolioProject\TechtonicFramework\packages\System.Runtime.4.3.0\ref\netstandard1.0\zh-hant\System.Runtime.xml", "XML", -15977, 0, 0, 0, 0, 0, -15977
"c:\Users\USERAS\Desktop\Projects\CSharp\PortfolioProject\TechtonicFramework\packages\System.Runtime.4.3.0\ref\netstandard1.2\System.Runtime.xml", "XML", -15642, 0, 0, 0, 0, 0, -15642
"c:\Users\USERAS\Desktop\Projects\CSharp\PortfolioProject\TechtonicFramework\packages\System.Runtime.4.3.0\ref\netstandard1.2\de\System.Runtime.xml", "XML", -15647, 0, 0, 0, 0, 0, -15647
"c:\Users\USERAS\Desktop\Projects\CSharp\PortfolioProject\TechtonicFramework\packages\System.Runtime.4.3.0\ref\netstandard1.2\es\System.Runtime.xml", "XML", -15620, 0, 0, 0, 0, 0, -15620
"c:\Users\USERAS\Desktop\Projects\CSharp\PortfolioProject\TechtonicFramework\packages\System.Runtime.4.3.0\ref\netstandard1.2\fr\System.Runtime.xml", "XML", -15856, 0, 0, 0, 0, 0, -15856
"c:\Users\USERAS\Desktop\Projects\CSharp\PortfolioProject\TechtonicFramework\packages\System.Runtime.4.3.0\ref\netstandard1.2\it\System.Runtime.xml", "XML", -15649, 0, 0, 0, 0, 0, -15649
"c:\Users\USERAS\Desktop\Projects\CSharp\PortfolioProject\TechtonicFramework\packages\System.Runtime.4.3.0\ref\netstandard1.2\ja\System.Runtime.xml", "XML", -16970, 0, 0, 0, 0, 0, -16970
"c:\Users\USERAS\Desktop\Projects\CSharp\PortfolioProject\TechtonicFramework\packages\System.Runtime.4.3.0\ref\netstandard1.2\ko\System.Runtime.xml", "XML", -16922, 0, 0, 0, 0, 0, -16922
"c:\Users\USERAS\Desktop\Projects\CSharp\PortfolioProject\TechtonicFramework\packages\System.Runtime.4.3.0\ref\netstandard1.2\ru\System.Runtime.xml", "XML", -15262, 0, 0, 0, 0, 0, -15262
"c:\Users\USERAS\Desktop\Projects\CSharp\PortfolioProject\TechtonicFramework\packages\System.Runtime.4.3.0\ref\netstandard1.2\zh-hans\System.Runtime.xml", "XML", -15922, 0, 0, 0, 0, 0, -15922
"c:\Users\USERAS\Desktop\Projects\CSharp\PortfolioProject\TechtonicFramework\packages\System.Runtime.4.3.0\ref\netstandard1.2\zh-hant\System.Runtime.xml", "XML", -15977, 0, 0, 0, 0, 0, -15977
"c:\Users\USERAS\Desktop\Projects\CSharp\PortfolioProject\TechtonicFramework\packages\System.Runtime.4.3.0\ref\netstandard1.3\System.Runtime.xml", "XML", -15642, 0, 0, 0, 0, 0, -15642
"c:\Users\USERAS\Desktop\Projects\CSharp\PortfolioProject\TechtonicFramework\packages\System.Runtime.4.3.0\ref\netstandard1.3\de\System.Runtime.xml", "XML", -15647, 0, 0, 0, 0, 0, -15647
"c:\Users\USERAS\Desktop\Projects\CSharp\PortfolioProject\TechtonicFramework\packages\System.Runtime.4.3.0\ref\netstandard1.3\es\System.Runtime.xml", "XML", -15620, 0, 0, 0, 0, 0, -15620
"c:\Users\USERAS\Desktop\Projects\CSharp\PortfolioProject\TechtonicFramework\packages\System.Runtime.4.3.0\ref\netstandard1.3\fr\System.Runtime.xml", "XML", -15856, 0, 0, 0, 0, 0, -15856
"c:\Users\USERAS\Desktop\Projects\CSharp\PortfolioProject\TechtonicFramework\packages\System.Runtime.4.3.0\ref\netstandard1.3\it\System.Runtime.xml", "XML", -15649, 0, 0, 0, 0, 0, -15649
"c:\Users\USERAS\Desktop\Projects\CSharp\PortfolioProject\TechtonicFramework\packages\System.Runtime.4.3.0\ref\netstandard1.3\ja\System.Runtime.xml", "XML", -16970, 0, 0, 0, 0, 0, -16970
"c:\Users\USERAS\Desktop\Projects\CSharp\PortfolioProject\TechtonicFramework\packages\System.Runtime.4.3.0\ref\netstandard1.3\ko\System.Runtime.xml", "XML", -16922, 0, 0, 0, 0, 0, -16922
"c:\Users\USERAS\Desktop\Projects\CSharp\PortfolioProject\TechtonicFramework\packages\System.Runtime.4.3.0\ref\netstandard1.3\ru\System.Runtime.xml", "XML", -15262, 0, 0, 0, 0, 0, -15262
"c:\Users\USERAS\Desktop\Projects\CSharp\PortfolioProject\TechtonicFramework\packages\System.Runtime.4.3.0\ref\netstandard1.3\zh-hans\System.Runtime.xml", "XML", -15922, 0, 0, 0, 0, 0, -15922
"c:\Users\USERAS\Desktop\Projects\CSharp\PortfolioProject\TechtonicFramework\packages\System.Runtime.4.3.0\ref\netstandard1.3\zh-hant\System.Runtime.xml", "XML", -15977, 0, 0, 0, 0, 0, -15977
"c:\Users\USERAS\Desktop\Projects\CSharp\PortfolioProject\TechtonicFramework\packages\System.Runtime.4.3.0\ref\netstandard1.5\System.Runtime.xml", "XML", -15642, 0, 0, 0, 0, 0, -15642
"c:\Users\USERAS\Desktop\Projects\CSharp\PortfolioProject\TechtonicFramework\packages\System.Runtime.4.3.0\ref\netstandard1.5\de\System.Runtime.xml", "XML", -15647, 0, 0, 0, 0, 0, -15647
"c:\Users\USERAS\Desktop\Projects\CSharp\PortfolioProject\TechtonicFramework\packages\System.Runtime.4.3.0\ref\netstandard1.5\es\System.Runtime.xml", "XML", -15620, 0, 0, 0, 0, 0, -15620
"c:\Users\USERAS\Desktop\Projects\CSharp\PortfolioProject\TechtonicFramework\packages\System.Runtime.4.3.0\ref\netstandard1.5\fr\System.Runtime.xml", "XML", -15856, 0, 0, 0, 0, 0, -15856
"c:\Users\USERAS\Desktop\Projects\CSharp\PortfolioProject\TechtonicFramework\packages\System.Runtime.4.3.0\ref\netstandard1.5\it\System.Runtime.xml", "XML", -15649, 0, 0, 0, 0, 0, -15649
"c:\Users\USERAS\Desktop\Projects\CSharp\PortfolioProject\TechtonicFramework\packages\System.Runtime.4.3.0\ref\netstandard1.5\ja\System.Runtime.xml", "XML", -16970, 0, 0, 0, 0, 0, -16970
"c:\Users\USERAS\Desktop\Projects\CSharp\PortfolioProject\TechtonicFramework\packages\System.Runtime.4.3.0\ref\netstandard1.5\ko\System.Runtime.xml", "XML", -16922, 0, 0, 0, 0, 0, -16922
"c:\Users\USERAS\Desktop\Projects\CSharp\PortfolioProject\TechtonicFramework\packages\System.Runtime.4.3.0\ref\netstandard1.5\ru\System.Runtime.xml", "XML", -15262, 0, 0, 0, 0, 0, -15262
"c:\Users\USERAS\Desktop\Projects\CSharp\PortfolioProject\TechtonicFramework\packages\System.Runtime.4.3.0\ref\netstandard1.5\zh-hans\System.Runtime.xml", "XML", -15922, 0, 0, 0, 0, 0, -15922
"c:\Users\USERAS\Desktop\Projects\CSharp\PortfolioProject\TechtonicFramework\packages\System.Runtime.4.3.0\ref\netstandard1.5\zh-hant\System.Runtime.xml", "XML", -15977, 0, 0, 0, 0, 0, -15977
"c:\Users\USERAS\Desktop\Projects\CSharp\PortfolioProject\TechtonicFramework\packages\System.Runtime.CompilerServices.Unsafe.4.5.3\lib\net461\System.Runtime.CompilerServices.Unsafe.xml", "XML", -200, 0, 0, 0, 0, 0, -200
"c:\Users\USERAS\Desktop\Projects\CSharp\PortfolioProject\TechtonicFramework\packages\System.Runtime.CompilerServices.Unsafe.4.5.3\lib\netcoreapp2.0\System.Runtime.CompilerServices.Unsafe.xml", "XML", -200, 0, 0, 0, 0, 0, -200
"c:\Users\USERAS\Desktop\Projects\CSharp\PortfolioProject\TechtonicFramework\packages\System.Runtime.CompilerServices.Unsafe.4.5.3\lib\netstandard1.0\System.Runtime.CompilerServices.Unsafe.xml", "XML", -200, 0, 0, 0, 0, 0, -200
"c:\Users\USERAS\Desktop\Projects\CSharp\PortfolioProject\TechtonicFramework\packages\System.Runtime.CompilerServices.Unsafe.4.5.3\lib\netstandard2.0\System.Runtime.CompilerServices.Unsafe.xml", "XML", -200, 0, 0, 0, 0, 0, -200
"c:\Users\USERAS\Desktop\Projects\CSharp\PortfolioProject\TechtonicFramework\packages\System.Runtime.CompilerServices.Unsafe.4.5.3\ref\net461\System.Runtime.CompilerServices.Unsafe.xml", "XML", -200, 0, 0, 0, 0, 0, -200
"c:\Users\USERAS\Desktop\Projects\CSharp\PortfolioProject\TechtonicFramework\packages\System.Runtime.CompilerServices.Unsafe.4.5.3\ref\netstandard1.0\System.Runtime.CompilerServices.Unsafe.xml", "XML", -200, 0, 0, 0, 0, 0, -200
"c:\Users\USERAS\Desktop\Projects\CSharp\PortfolioProject\TechtonicFramework\packages\System.Runtime.CompilerServices.Unsafe.4.5.3\ref\netstandard2.0\System.Runtime.CompilerServices.Unsafe.xml", "XML", -200, 0, 0, 0, 0, 0, -200
"c:\Users\USERAS\Desktop\Projects\CSharp\PortfolioProject\TechtonicFramework\packages\System.Security.Cryptography.Encoding.4.3.0\ref\netstandard1.3\System.Security.Cryptography.Encoding.xml", "XML", -204, 0, 0, 0, 0, 0, -204
"c:\Users\USERAS\Desktop\Projects\CSharp\PortfolioProject\TechtonicFramework\packages\System.Security.Cryptography.Encoding.4.3.0\ref\netstandard1.3\de\System.Security.Cryptography.Encoding.xml", "XML", -204, 0, 0, 0, 0, 0, -204
"c:\Users\USERAS\Desktop\Projects\CSharp\PortfolioProject\TechtonicFramework\packages\System.Security.Cryptography.Encoding.4.3.0\ref\netstandard1.3\es\System.Security.Cryptography.Encoding.xml", "XML", -202, 0, 0, 0, 0, 0, -202
"c:\Users\USERAS\Desktop\Projects\CSharp\PortfolioProject\TechtonicFramework\packages\System.Security.Cryptography.Encoding.4.3.0\ref\netstandard1.3\fr\System.Security.Cryptography.Encoding.xml", "XML", -204, 0, 0, 0, 0, 0, -204
"c:\Users\USERAS\Desktop\Projects\CSharp\PortfolioProject\TechtonicFramework\packages\System.Security.Cryptography.Encoding.4.3.0\ref\netstandard1.3\it\System.Security.Cryptography.Encoding.xml", "XML", -204, 0, 0, 0, 0, 0, -204
"c:\Users\USERAS\Desktop\Projects\CSharp\PortfolioProject\TechtonicFramework\packages\System.Security.Cryptography.Encoding.4.3.0\ref\netstandard1.3\ja\System.Security.Cryptography.Encoding.xml", "XML", -236, 0, 0, 0, 0, 0, -236
"c:\Users\USERAS\Desktop\Projects\CSharp\PortfolioProject\TechtonicFramework\packages\System.Security.Cryptography.Encoding.4.3.0\ref\netstandard1.3\ko\System.Security.Cryptography.Encoding.xml", "XML", -235, 0, 0, 0, 0, 0, -235
"c:\Users\USERAS\Desktop\Projects\CSharp\PortfolioProject\TechtonicFramework\packages\System.Security.Cryptography.Encoding.4.3.0\ref\netstandard1.3\ru\System.Security.Cryptography.Encoding.xml", "XML", -197, 0, 0, 0, 0, 0, -197
"c:\Users\USERAS\Desktop\Projects\CSharp\PortfolioProject\TechtonicFramework\packages\System.Security.Cryptography.Encoding.4.3.0\ref\netstandard1.3\zh-hans\System.Security.Cryptography.Encoding.xml", "XML", -214, 0, 0, 0, 0, 0, -214
"c:\Users\USERAS\Desktop\Projects\CSharp\PortfolioProject\TechtonicFramework\packages\System.Security.Cryptography.Encoding.4.3.0\ref\netstandard1.3\zh-hant\System.Security.Cryptography.Encoding.xml", "XML", -212, 0, 0, 0, 0, 0, -212
"c:\Users\USERAS\Desktop\Projects\CSharp\PortfolioProject\TechtonicFramework\packages\System.Security.Cryptography.X509Certificates.4.3.0\ref\netstandard1.3\System.Security.Cryptography.X509Certificates.xml", "XML", -1556, 0, 0, 0, 0, 0, -1556
"c:\Users\USERAS\Desktop\Projects\CSharp\PortfolioProject\TechtonicFramework\packages\System.Security.Cryptography.X509Certificates.4.3.0\ref\netstandard1.3\de\System.Security.Cryptography.X509Certificates.xml", "XML", -1558, 0, 0, 0, 0, 0, -1558
"c:\Users\USERAS\Desktop\Projects\CSharp\PortfolioProject\TechtonicFramework\packages\System.Security.Cryptography.X509Certificates.4.3.0\ref\netstandard1.3\es\System.Security.Cryptography.X509Certificates.xml", "XML", -1563, 0, 0, 0, 0, 0, -1563
"c:\Users\USERAS\Desktop\Projects\CSharp\PortfolioProject\TechtonicFramework\packages\System.Security.Cryptography.X509Certificates.4.3.0\ref\netstandard1.3\fr\System.Security.Cryptography.X509Certificates.xml", "XML", -1570, 0, 0, 0, 0, 0, -1570
"c:\Users\USERAS\Desktop\Projects\CSharp\PortfolioProject\TechtonicFramework\packages\System.Security.Cryptography.X509Certificates.4.3.0\ref\netstandard1.3\it\System.Security.Cryptography.X509Certificates.xml", "XML", -1559, 0, 0, 0, 0, 0, -1559
"c:\Users\USERAS\Desktop\Projects\CSharp\PortfolioProject\TechtonicFramework\packages\System.Security.Cryptography.X509Certificates.4.3.0\ref\netstandard1.3\ja\System.Security.Cryptography.X509Certificates.xml", "XML", -1723, 0, 0, 0, 0, 0, -1723
"c:\Users\USERAS\Desktop\Projects\CSharp\PortfolioProject\TechtonicFramework\packages\System.Security.Cryptography.X509Certificates.4.3.0\ref\netstandard1.3\ko\System.Security.Cryptography.X509Certificates.xml", "XML", -1726, 0, 0, 0, 0, 0, -1726
"c:\Users\USERAS\Desktop\Projects\CSharp\PortfolioProject\TechtonicFramework\packages\System.Security.Cryptography.X509Certificates.4.3.0\ref\netstandard1.3\ru\System.Security.Cryptography.X509Certificates.xml", "XML", -1523, 0, 0, 0, 0, 0, -1523
"c:\Users\USERAS\Desktop\Projects\CSharp\PortfolioProject\TechtonicFramework\packages\System.Security.Cryptography.X509Certificates.4.3.0\ref\netstandard1.3\zh-hans\System.Security.Cryptography.X509Certificates.xml", "XML", -1633, 0, 0, 0, 0, 0, -1633
"c:\Users\USERAS\Desktop\Projects\CSharp\PortfolioProject\TechtonicFramework\packages\System.Security.Cryptography.X509Certificates.4.3.0\ref\netstandard1.3\zh-hant\System.Security.Cryptography.X509Certificates.xml", "XML", -1646, 0, 0, 0, 0, 0, -1646
"c:\Users\USERAS\Desktop\Projects\CSharp\PortfolioProject\TechtonicFramework\packages\System.Security.Cryptography.X509Certificates.4.3.0\ref\netstandard1.4\System.Security.Cryptography.X509Certificates.xml", "XML", -1556, 0, 0, 0, 0, 0, -1556
"c:\Users\USERAS\Desktop\Projects\CSharp\PortfolioProject\TechtonicFramework\packages\System.Security.Cryptography.X509Certificates.4.3.0\ref\netstandard1.4\de\System.Security.Cryptography.X509Certificates.xml", "XML", -1558, 0, 0, 0, 0, 0, -1558
"c:\Users\USERAS\Desktop\Projects\CSharp\PortfolioProject\TechtonicFramework\packages\System.Security.Cryptography.X509Certificates.4.3.0\ref\netstandard1.4\es\System.Security.Cryptography.X509Certificates.xml", "XML", -1563, 0, 0, 0, 0, 0, -1563
"c:\Users\USERAS\Desktop\Projects\CSharp\PortfolioProject\TechtonicFramework\packages\System.Security.Cryptography.X509Certificates.4.3.0\ref\netstandard1.4\fr\System.Security.Cryptography.X509Certificates.xml", "XML", -1570, 0, 0, 0, 0, 0, -1570
"c:\Users\USERAS\Desktop\Projects\CSharp\PortfolioProject\TechtonicFramework\packages\System.Security.Cryptography.X509Certificates.4.3.0\ref\netstandard1.4\it\System.Security.Cryptography.X509Certificates.xml", "XML", -1559, 0, 0, 0, 0, 0, -1559
"c:\Users\USERAS\Desktop\Projects\CSharp\PortfolioProject\TechtonicFramework\packages\System.Security.Cryptography.X509Certificates.4.3.0\ref\netstandard1.4\ja\System.Security.Cryptography.X509Certificates.xml", "XML", -1723, 0, 0, 0, 0, 0, -1723
"c:\Users\USERAS\Desktop\Projects\CSharp\PortfolioProject\TechtonicFramework\packages\System.Security.Cryptography.X509Certificates.4.3.0\ref\netstandard1.4\ko\System.Security.Cryptography.X509Certificates.xml", "XML", -1726, 0, 0, 0, 0, 0, -1726
"c:\Users\USERAS\Desktop\Projects\CSharp\PortfolioProject\TechtonicFramework\packages\System.Security.Cryptography.X509Certificates.4.3.0\ref\netstandard1.4\ru\System.Security.Cryptography.X509Certificates.xml", "XML", -1523, 0, 0, 0, 0, 0, -1523
"c:\Users\USERAS\Desktop\Projects\CSharp\PortfolioProject\TechtonicFramework\packages\System.Security.Cryptography.X509Certificates.4.3.0\ref\netstandard1.4\zh-hans\System.Security.Cryptography.X509Certificates.xml", "XML", -1633, 0, 0, 0, 0, 0, -1633
"c:\Users\USERAS\Desktop\Projects\CSharp\PortfolioProject\TechtonicFramework\packages\System.Security.Cryptography.X509Certificates.4.3.0\ref\netstandard1.4\zh-hant\System.Security.Cryptography.X509Certificates.xml", "XML", -1646, 0, 0, 0, 0, 0, -1646
"c:\Users\USERAS\Desktop\Projects\CSharp\PortfolioProject\TechtonicFramework\packages\System.Text.RegularExpressions.4.3.1\ref\netcore50\System.Text.RegularExpressions.xml", "XML", -844, 0, 0, 0, 0, 0, -844
"c:\Users\USERAS\Desktop\Projects\CSharp\PortfolioProject\TechtonicFramework\packages\System.Text.RegularExpressions.4.3.1\ref\netcore50\de\System.Text.RegularExpressions.xml", "XML", -844, 0, 0, 0, 0, 0, -844
"c:\Users\USERAS\Desktop\Projects\CSharp\PortfolioProject\TechtonicFramework\packages\System.Text.RegularExpressions.4.3.1\ref\netcore50\es\System.Text.RegularExpressions.xml", "XML", -808, 0, 0, 0, 0, 0, -808
"c:\Users\USERAS\Desktop\Projects\CSharp\PortfolioProject\TechtonicFramework\packages\System.Text.RegularExpressions.4.3.1\ref\netcore50\fr\System.Text.RegularExpressions.xml", "XML", -844, 0, 0, 0, 0, 0, -844
"c:\Users\USERAS\Desktop\Projects\CSharp\PortfolioProject\TechtonicFramework\packages\System.Text.RegularExpressions.4.3.1\ref\netcore50\it\System.Text.RegularExpressions.xml", "XML", -843, 0, 0, 0, 0, 0, -843
"c:\Users\USERAS\Desktop\Projects\CSharp\PortfolioProject\TechtonicFramework\packages\System.Text.RegularExpressions.4.3.1\ref\netcore50\ja\System.Text.RegularExpressions.xml", "XML", -864, 0, 0, 0, 0, 0, -864
"c:\Users\USERAS\Desktop\Projects\CSharp\PortfolioProject\TechtonicFramework\packages\System.Text.RegularExpressions.4.3.1\ref\netcore50\ko\System.Text.RegularExpressions.xml", "XML", -863, 0, 0, 0, 0, 0, -863
"c:\Users\USERAS\Desktop\Projects\CSharp\PortfolioProject\TechtonicFramework\packages\System.Text.RegularExpressions.4.3.1\ref\netcore50\ru\System.Text.RegularExpressions.xml", "XML", -777, 0, 0, 0, 0, 0, -777
"c:\Users\USERAS\Desktop\Projects\CSharp\PortfolioProject\TechtonicFramework\packages\System.Text.RegularExpressions.4.3.1\ref\netcore50\zh-hans\System.Text.RegularExpressions.xml", "XML", -849, 0, 0, 0, 0, 0, -849
"c:\Users\USERAS\Desktop\Projects\CSharp\PortfolioProject\TechtonicFramework\packages\System.Text.RegularExpressions.4.3.1\ref\netcore50\zh-hant\System.Text.RegularExpressions.xml", "XML", -852, 0, 0, 0, 0, 0, -852
"c:\Users\USERAS\Desktop\Projects\CSharp\PortfolioProject\TechtonicFramework\packages\System.Text.RegularExpressions.4.3.1\ref\netstandard1.0\System.Text.RegularExpressions.xml", "XML", -844, 0, 0, 0, 0, 0, -844
"c:\Users\USERAS\Desktop\Projects\CSharp\PortfolioProject\TechtonicFramework\packages\System.Text.RegularExpressions.4.3.1\ref\netstandard1.0\de\System.Text.RegularExpressions.xml", "XML", -844, 0, 0, 0, 0, 0, -844
"c:\Users\USERAS\Desktop\Projects\CSharp\PortfolioProject\TechtonicFramework\packages\System.Text.RegularExpressions.4.3.1\ref\netstandard1.0\es\System.Text.RegularExpressions.xml", "XML", -808, 0, 0, 0, 0, 0, -808
"c:\Users\USERAS\Desktop\Projects\CSharp\PortfolioProject\TechtonicFramework\packages\System.Text.RegularExpressions.4.3.1\ref\netstandard1.0\fr\System.Text.RegularExpressions.xml", "XML", -844, 0, 0, 0, 0, 0, -844
"c:\Users\USERAS\Desktop\Projects\CSharp\PortfolioProject\TechtonicFramework\packages\System.Text.RegularExpressions.4.3.1\ref\netstandard1.0\it\System.Text.RegularExpressions.xml", "XML", -843, 0, 0, 0, 0, 0, -843
"c:\Users\USERAS\Desktop\Projects\CSharp\PortfolioProject\TechtonicFramework\packages\System.Text.RegularExpressions.4.3.1\ref\netstandard1.0\ja\System.Text.RegularExpressions.xml", "XML", -864, 0, 0, 0, 0, 0, -864
"c:\Users\USERAS\Desktop\Projects\CSharp\PortfolioProject\TechtonicFramework\packages\System.Text.RegularExpressions.4.3.1\ref\netstandard1.0\ko\System.Text.RegularExpressions.xml", "XML", -863, 0, 0, 0, 0, 0, -863
"c:\Users\USERAS\Desktop\Projects\CSharp\PortfolioProject\TechtonicFramework\packages\System.Text.RegularExpressions.4.3.1\ref\netstandard1.0\ru\System.Text.RegularExpressions.xml", "XML", -777, 0, 0, 0, 0, 0, -777
"c:\Users\USERAS\Desktop\Projects\CSharp\PortfolioProject\TechtonicFramework\packages\System.Text.RegularExpressions.4.3.1\ref\netstandard1.0\zh-hans\System.Text.RegularExpressions.xml", "XML", -849, 0, 0, 0, 0, 0, -849
"c:\Users\USERAS\Desktop\Projects\CSharp\PortfolioProject\TechtonicFramework\packages\System.Text.RegularExpressions.4.3.1\ref\netstandard1.0\zh-hant\System.Text.RegularExpressions.xml", "XML", -852, 0, 0, 0, 0, 0, -852
"c:\Users\USERAS\Desktop\Projects\CSharp\PortfolioProject\TechtonicFramework\packages\System.Text.RegularExpressions.4.3.1\ref\netstandard1.3\System.Text.RegularExpressions.xml", "XML", -844, 0, 0, 0, 0, 0, -844
"c:\Users\USERAS\Desktop\Projects\CSharp\PortfolioProject\TechtonicFramework\packages\System.Text.RegularExpressions.4.3.1\ref\netstandard1.3\de\System.Text.RegularExpressions.xml", "XML", -844, 0, 0, 0, 0, 0, -844
"c:\Users\USERAS\Desktop\Projects\CSharp\PortfolioProject\TechtonicFramework\packages\System.Text.RegularExpressions.4.3.1\ref\netstandard1.3\es\System.Text.RegularExpressions.xml", "XML", -808, 0, 0, 0, 0, 0, -808
"c:\Users\USERAS\Desktop\Projects\CSharp\PortfolioProject\TechtonicFramework\packages\System.Text.RegularExpressions.4.3.1\ref\netstandard1.3\fr\System.Text.RegularExpressions.xml", "XML", -844, 0, 0, 0, 0, 0, -844
"c:\Users\USERAS\Desktop\Projects\CSharp\PortfolioProject\TechtonicFramework\packages\System.Text.RegularExpressions.4.3.1\ref\netstandard1.3\it\System.Text.RegularExpressions.xml", "XML", -843, 0, 0, 0, 0, 0, -843
"c:\Users\USERAS\Desktop\Projects\CSharp\PortfolioProject\TechtonicFramework\packages\System.Text.RegularExpressions.4.3.1\ref\netstandard1.3\ja\System.Text.RegularExpressions.xml", "XML", -864, 0, 0, 0, 0, 0, -864
"c:\Users\USERAS\Desktop\Projects\CSharp\PortfolioProject\TechtonicFramework\packages\System.Text.RegularExpressions.4.3.1\ref\netstandard1.3\ko\System.Text.RegularExpressions.xml", "XML", -863, 0, 0, 0, 0, 0, -863
"c:\Users\USERAS\Desktop\Projects\CSharp\PortfolioProject\TechtonicFramework\packages\System.Text.RegularExpressions.4.3.1\ref\netstandard1.3\ru\System.Text.RegularExpressions.xml", "XML", -777, 0, 0, 0, 0, 0, -777
"c:\Users\USERAS\Desktop\Projects\CSharp\PortfolioProject\TechtonicFramework\packages\System.Text.RegularExpressions.4.3.1\ref\netstandard1.3\zh-hans\System.Text.RegularExpressions.xml", "XML", -849, 0, 0, 0, 0, 0, -849
"c:\Users\USERAS\Desktop\Projects\CSharp\PortfolioProject\TechtonicFramework\packages\System.Text.RegularExpressions.4.3.1\ref\netstandard1.3\zh-hant\System.Text.RegularExpressions.xml", "XML", -852, 0, 0, 0, 0, 0, -852
"c:\Users\USERAS\Desktop\Projects\CSharp\PortfolioProject\TechtonicFramework\packages\System.Text.RegularExpressions.4.3.1\ref\netstandard1.6\System.Text.RegularExpressions.xml", "XML", -844, 0, 0, 0, 0, 0, -844
"c:\Users\USERAS\Desktop\Projects\CSharp\PortfolioProject\TechtonicFramework\packages\System.Text.RegularExpressions.4.3.1\ref\netstandard1.6\de\System.Text.RegularExpressions.xml", "XML", -844, 0, 0, 0, 0, 0, -844
"c:\Users\USERAS\Desktop\Projects\CSharp\PortfolioProject\TechtonicFramework\packages\System.Text.RegularExpressions.4.3.1\ref\netstandard1.6\es\System.Text.RegularExpressions.xml", "XML", -808, 0, 0, 0, 0, 0, -808
"c:\Users\USERAS\Desktop\Projects\CSharp\PortfolioProject\TechtonicFramework\packages\System.Text.RegularExpressions.4.3.1\ref\netstandard1.6\fr\System.Text.RegularExpressions.xml", "XML", -844, 0, 0, 0, 0, 0, -844
"c:\Users\USERAS\Desktop\Projects\CSharp\PortfolioProject\TechtonicFramework\packages\System.Text.RegularExpressions.4.3.1\ref\netstandard1.6\it\System.Text.RegularExpressions.xml", "XML", -843, 0, 0, 0, 0, 0, -843
"c:\Users\USERAS\Desktop\Projects\CSharp\PortfolioProject\TechtonicFramework\packages\System.Text.RegularExpressions.4.3.1\ref\netstandard1.6\ja\System.Text.RegularExpressions.xml", "XML", -864, 0, 0, 0, 0, 0, -864
"c:\Users\USERAS\Desktop\Projects\CSharp\PortfolioProject\TechtonicFramework\packages\System.Text.RegularExpressions.4.3.1\ref\netstandard1.6\ko\System.Text.RegularExpressions.xml", "XML", -863, 0, 0, 0, 0, 0, -863
"c:\Users\USERAS\Desktop\Projects\CSharp\PortfolioProject\TechtonicFramework\packages\System.Text.RegularExpressions.4.3.1\ref\netstandard1.6\ru\System.Text.RegularExpressions.xml", "XML", -777, 0, 0, 0, 0, 0, -777
"c:\Users\USERAS\Desktop\Projects\CSharp\PortfolioProject\TechtonicFramework\packages\System.Text.RegularExpressions.4.3.1\ref\netstandard1.6\zh-hans\System.Text.RegularExpressions.xml", "XML", -849, 0, 0, 0, 0, 0, -849
"c:\Users\USERAS\Desktop\Projects\CSharp\PortfolioProject\TechtonicFramework\packages\System.Text.RegularExpressions.4.3.1\ref\netstandard1.6\zh-hant\System.Text.RegularExpressions.xml", "XML", -852, 0, 0, 0, 0, 0, -852
"c:\Users\USERAS\Desktop\Projects\CSharp\PortfolioProject\TechtonicFramework\packages\System.Threading.Tasks.Extensions.4.5.4\lib\net461\System.Threading.Tasks.Extensions.xml", "XML", -165, 0, 0, 0, 0, -1, -166
"c:\Users\USERAS\Desktop\Projects\CSharp\PortfolioProject\TechtonicFramework\packages\System.Threading.Tasks.Extensions.4.5.4\lib\netstandard1.0\System.Threading.Tasks.Extensions.xml", "XML", -165, 0, 0, 0, 0, -1, -166
"c:\Users\USERAS\Desktop\Projects\CSharp\PortfolioProject\TechtonicFramework\packages\System.Threading.Tasks.Extensions.4.5.4\lib\netstandard2.0\System.Threading.Tasks.Extensions.xml", "XML", -165, 0, 0, 0, 0, -1, -166
"c:\Users\USERAS\Desktop\Projects\CSharp\PortfolioProject\TechtonicFramework\packages\System.Threading.Tasks.Extensions.4.5.4\lib\portable-net45+win8+wp8+wpa81\System.Threading.Tasks.Extensions.xml", "XML", -165, 0, 0, 0, 0, -1, -166
"c:\Users\USERAS\Desktop\Projects\CSharp\PortfolioProject\TechtonicFramework\packages\Unity.AspNet.WebApi.5.11.2\lib\net45\Unity.AspNet.WebApi.xml", "XML", -87, 0, 0, 0, 0, -1, -88
"c:\Users\USERAS\Desktop\Projects\CSharp\PortfolioProject\TechtonicFramework\packages\Unity.AspNet.WebApi.5.11.2\lib\net47\Unity.AspNet.WebApi.xml", "XML", -87, 0, 0, 0, 0, -1, -88
"c:\Users\USERAS\Desktop\Projects\CSharp\PortfolioProject\TechtonicFramework\packages\WebGrease.1.5.2\tools\install.ps1", "PowerShell", 0, 0, -54, 0, -16, -21, -91
"c:\Users\USERAS\Desktop\Projects\CSharp\PortfolioProject\TechtonicFramework\packages\WebGrease.1.5.2\tools\uninstall.ps1", "PowerShell", 0, 0, -43, 0, -6, -15, -64
"Total", "-", -1365644, -266, -1168, -12, -2620, -1440, -1371150